####################
#..................#
#.###.###.###.###.#
#                  #
#.###.###.###.###.#
#..................#
#                  #
#                  #
#                  #
####################
