####################
# .................#
#.###.###.###.###.#
#.#...........#...#
#.###.###.###.###.#
#......P..........#
#........$........#
#.#...........#...#
#.###.###.###.###.#
####################
E 5 10
E 7 15
E 3 5