####################
#..................#
#                  #
#                  #
#                  #
#                  #
#                  #
#                  #
#                  #
####################
